afrikaans : af
amharic : am
arabic : ar
azerbaijani : az
belarusian : be
bulgarian : bg
bengali : bn
bosnian : bs
catalan : ca
cebuano : ceb
corsican : co
czech : cs
welsh : cy
danish : da
german : de
greek : el
english : en
esperanto : eo
spanish : es
estonian : et
basque : eu
persian : fa
finnish : fi
Filipino : fil
french : fr
frisian : fy
irish : ga
scots gaelic : gd
galician : gl
gujarati : gu
hausa : ha
hawaiian : haw
Hebrew : he
hindi : hi
hmong : hmn
croatian : hr
haitian creole : ht
hungarian : hu
armenian : hy
indonesian : id
igbo : ig
icelandic : is
italian : it
hebrew : iw
japanese : ja
javanese : jw
georgian : ka
kazakh : kk
khmer : km
kannada : kn
korean : ko
kurdish (kurmanji) : ku
kyrgyz : ky
latin : la
luxembourgish : lb
lao : lo
lithuanian : lt
latvian : lv
malagasy : mg
maori : mi
macedonian : mk
malayalam : ml
mongolian : mn
marathi : mr
malay : ms
maltese : mt
myanmar (burmese) : my
nepali : ne
dutch : nl
norwegian : no
chichewa : ny
punjabi : pa
polish : pl
pashto : ps
portuguese : pt
romanian : ro
russian : ru
sindhi : sd
sinhala : si
slovak : sk
slovenian : sl
samoan : sm
shona : sn
somali : so
albanian : sq
serbian : sr
sesotho : st
sundanese : su
swedish : sv
swahili : sw
tamil : ta
telugu : te
tajik : tg
thai : th
filipino : tl
turkish : tr
ukrainian : uk
urdu : ur
uzbek : uz
vietnamese : vi
xhosa : xh
yiddish : yi
yoruba : yo
chinese (simplified) : zh-cn
chinese (traditional) : zh-tw
zulu : zu
